20,17,21,21,17,17,19,17,17,17,17,17,18,17,17,17,20,17,19,17,
22,22,21,21,22,22,22,22,22,22,22,22,22,22,22,22,22,22,22,22,
22,22,21,21,22,15,22,22,22,21,21,21,21,21,21,21,21,21,22,22,
22,22,21,21,22,22,22,22,22,21,21,21,21,21,21,21,21,21,22,22,
22,27,21,21,22,22,16,22,22,21,21,22,22,22,22,22,21,21,22,22,
22,22,21,21,22,22,22,22,22,21,21,22,22,22,27,22,21,21,22,26,
22,22,21,21,22,22,22,22,22,21,21,22,15,22,22,22,21,21,22,22,
22,22,21,21,21,21,21,21,21,21,21,21,21,21,21,21,21,21,22,22,
22,22,21,21,21,21,21,21,21,21,21,21,21,21,21,21,21,21,22,22,
22,15,21,21,22,22,24,22,22,21,21,21,21,21,21,21,21,21,24,22,
22,22,21,21,22,26,22,22,22,21,21,21,21,21,21,21,21,21,22,22,
22,22,21,21,22,22,22,27,22,21,21,21,21,21,21,21,21,21,22,22,
22,22,21,21,22,22,25,22,22,21,21,21,21,21,21,21,21,21,21,21,
23,22,21,21,22,22,22,22,22,21,21,21,21,21,21,21,21,21,21,21,
22,22,21,21,21,21,21,21,21,21,21,21,21,21,21,21,22,22,22,22,
22,22,21,21,21,21,21,21,21,21,21,21,21,21,21,21,22,22,22,22,
21,21,21,21,21,21,21,21,21,21,21,21,21,21,21,21,22,22,16,22,
21,21,21,21,21,21,21,21,21,21,21,21,21,21,21,21,22,22,22,22,
22,22,22,22,25,22,22,22,22,21,21,22,27,22,22,22,22,23,22,22,
22,22,23,22,22,16,22,22,22,21,21,22,22,22,22,25,22,22,22,22