1,1,1,1,1,1,1,1,1,1,1,1,1,1,1,1,1,1,1,1,1,1,1,1,1,1,1,1,1,1,1,1,1,1,1,1,1,1,1,1,1,1,1,1,1,1,1,1,1,1,
1,6,6,6,6,6,6,6,6,6,6,6,6,6,6,6,6,6,6,6,6,6,6,6,6,6,6,6,6,6,6,6,6,6,6,6,6,6,6,6,6,6,6,6,6,6,6,6,7,1,
1,7,10,10,10,10,10,10,10,10,10,10,10,10,10,10,10,10,10,10,10,10,10,10,3,3,10,5,5,5,5,5,5,5,5,5,5,5,5,5,5,5,5,5,5,5,5,5,7,1,
1,7,10,3,3,3,3,3,3,3,3,3,3,3,3,3,3,10,14,5,5,5,13,10,3,3,10,5,5,5,5,5,5,5,5,5,5,10,10,10,10,10,10,10,10,10,5,5,7,1,
1,7,10,3,3,3,3,3,3,3,3,3,3,3,3,3,3,3,3,3,3,3,3,3,3,3,10,5,5,5,5,5,5,5,5,5,5,5,13,5,13,10,10,10,10,5,5,5,7,1,
1,7,10,3,3,3,3,3,3,3,3,3,3,3,3,3,3,3,3,3,3,3,3,3,3,3,10,5,5,5,14,5,5,5,5,5,5,5,5,5,5,5,5,5,5,5,5,5,7,1,
1,7,10,3,3,3,3,3,3,3,3,3,3,3,3,3,3,5,8,8,8,8,8,8,3,3,10,5,5,5,10,10,5,5,5,5,5,5,5,5,5,5,5,5,5,5,5,5,7,1,
1,7,10,10,13,3,3,10,10,5,5,10,10,3,3,5,5,5,5,5,5,5,5,5,3,3,10,5,5,5,10,5,5,5,5,5,5,5,5,5,5,5,5,5,5,5,5,5,7,1,
1,7,11,11,11,3,3,11,11,11,11,11,11,3,3,11,11,11,8,8,8,8,8,8,3,3,10,5,5,10,10,5,5,5,5,5,5,5,5,5,5,5,5,5,5,5,5,5,7,1,
1,7,11,3,3,3,3,3,3,11,11,3,3,3,3,3,3,11,5,5,5,5,5,5,3,3,10,5,5,10,5,5,5,5,5,5,5,5,5,10,10,10,10,10,10,5,5,5,7,1,
1,7,11,3,3,3,3,3,3,11,11,3,3,3,3,3,3,11,8,8,8,8,8,8,3,3,10,10,10,10,5,5,5,5,5,5,10,10,10,10,5,5,5,5,5,5,5,5,7,1,
1,7,11,3,3,3,3,3,3,3,3,3,3,3,3,3,3,11,5,5,5,5,5,5,3,3,10,5,5,5,5,5,5,5,10,10,10,5,5,5,5,5,5,5,5,5,5,5,7,1,
1,7,11,3,3,3,3,3,3,3,3,3,3,3,3,3,3,11,8,8,8,8,8,8,3,3,10,5,5,5,5,5,5,10,10,5,5,5,5,5,5,5,5,5,5,5,5,5,7,1,
1,7,11,3,3,3,3,3,3,11,11,3,3,3,3,3,3,11,5,5,5,5,5,5,3,3,10,5,5,5,5,5,5,5,5,5,5,5,5,5,5,5,5,5,5,5,5,5,7,1,
1,7,11,3,3,3,3,3,3,11,11,3,3,3,3,3,3,11,8,8,8,8,8,8,3,3,5,5,5,5,5,5,5,5,5,5,5,5,5,5,5,5,5,5,5,5,5,5,7,1,
1,7,9,9,9,3,3,9,9,9,9,9,9,3,3,9,9,9,5,5,5,5,5,5,3,3,5,5,5,5,5,5,5,5,5,5,5,5,5,5,5,5,5,5,5,5,5,5,7,1,
1,7,10,10,10,3,3,10,10,10,10,10,10,3,3,10,10,10,8,8,8,8,8,8,3,3,10,13,5,5,5,5,5,5,5,5,5,5,5,5,5,5,5,5,5,5,5,5,7,1,
1,7,10,3,3,3,3,3,3,10,10,3,3,3,3,3,3,10,5,5,5,5,5,5,3,3,10,5,5,5,5,5,5,5,5,5,5,5,11,11,5,5,11,11,5,5,5,5,7,1,
1,7,10,3,3,3,3,3,3,10,10,3,3,3,3,3,3,10,5,5,13,14,9,9,3,3,9,9,5,5,5,5,5,5,5,5,5,5,11,11,5,5,11,11,5,5,5,5,7,1,
1,7,10,3,3,3,3,3,3,10,10,3,3,3,3,3,3,10,5,13,9,9,9,3,3,3,3,9,9,9,5,5,5,5,5,5,5,5,11,10,5,5,10,10,5,5,5,5,7,1,
1,7,10,3,3,3,3,3,3,10,10,3,3,3,3,3,3,10,5,9,9,3,3,3,5,5,3,3,3,9,9,5,5,5,5,5,5,5,11,10,5,5,11,10,5,5,5,5,7,1,
1,7,10,3,3,3,3,3,3,10,10,3,3,3,3,3,3,10,5,9,3,3,5,5,5,5,5,5,3,3,9,11,11,11,11,10,11,11,10,11,5,5,11,10,11,11,11,11,7,1,
1,7,11,11,11,3,3,11,11,11,11,11,11,3,3,11,11,11,9,9,3,5,5,5,3,3,5,5,5,3,9,9,10,10,10,10,11,11,11,11,5,5,10,10,10,10,10,11,7,1,
1,7,10,10,10,3,3,8,8,8,8,8,8,3,3,10,10,10,9,3,3,5,5,3,3,3,3,5,5,3,3,9,11,11,5,5,5,5,5,5,5,5,5,5,5,5,5,5,7,1,
1,7,3,3,3,3,3,3,3,3,3,3,3,3,3,3,3,3,3,3,5,5,3,3,5,5,3,3,5,5,3,5,5,5,5,5,5,5,5,5,5,5,5,5,5,5,5,5,7,1,
1,7,3,3,3,3,3,3,3,3,3,3,3,3,3,3,3,3,3,3,5,5,3,3,5,5,3,3,5,5,3,5,5,5,5,5,5,11,11,5,5,5,5,5,5,5,5,5,7,1,
1,7,8,13,8,3,3,10,11,11,11,11,10,3,3,10,10,8,8,3,3,5,5,3,3,3,3,5,5,3,3,9,5,5,5,5,11,10,5,5,5,5,11,5,5,5,5,5,7,1,
1,7,8,5,8,3,3,10,11,11,11,11,10,3,3,10,10,8,8,8,3,5,5,5,3,3,5,5,5,3,9,9,5,5,5,11,11,11,5,5,5,11,11,5,5,5,5,5,7,1,
1,7,8,5,8,3,3,10,11,3,3,11,10,3,3,10,10,8,8,8,3,3,5,5,5,5,5,5,3,3,9,5,5,5,11,10,11,5,5,5,11,10,11,5,5,5,5,5,7,1,
1,7,3,3,3,3,3,10,11,3,3,11,10,3,3,5,5,5,5,11,10,3,3,3,5,5,3,3,3,9,9,5,5,5,11,11,5,5,5,5,11,10,10,11,11,5,5,5,7,1,
1,7,10,3,3,10,10,10,11,3,3,11,10,3,3,8,8,8,8,8,11,10,10,3,3,3,3,9,9,9,5,5,5,11,10,11,5,5,5,5,11,10,10,11,11,5,5,5,7,1,
1,7,10,3,3,11,11,11,11,3,3,11,10,3,3,5,5,5,5,5,5,5,11,10,3,3,9,9,5,5,5,5,5,10,10,11,5,5,5,5,11,10,10,10,10,5,5,5,7,1,
1,7,10,3,3,3,3,3,3,3,3,11,10,3,3,8,8,8,8,8,8,8,8,10,3,3,10,5,5,5,5,5,11,10,11,11,5,5,5,5,5,11,10,10,10,5,5,5,7,1,
1,7,10,3,3,3,3,3,3,3,3,11,10,3,3,3,3,3,3,3,3,3,3,3,3,3,10,5,5,14,5,11,11,10,11,5,5,5,5,5,5,5,11,11,11,5,5,5,7,1,
1,7,10,3,3,3,3,3,3,3,3,11,10,3,3,3,3,3,3,3,3,3,3,3,3,3,10,5,5,5,10,10,10,10,11,5,5,5,5,5,5,5,13,10,10,5,5,5,7,1,
1,7,10,3,3,3,3,3,3,3,3,11,10,10,10,10,10,10,10,10,10,10,10,10,3,3,10,11,10,10,10,11,10,11,5,5,5,5,5,5,5,5,5,10,10,5,5,5,7,1,
1,7,10,3,3,3,3,3,3,3,3,3,3,3,3,3,3,3,3,3,3,3,3,3,3,3,10,10,10,11,11,11,5,5,5,5,5,5,5,5,5,5,5,10,10,5,5,5,7,1,
1,7,10,3,3,3,3,3,3,3,3,3,3,3,3,3,3,3,3,3,3,3,3,3,3,3,11,11,11,11,11,5,5,5,5,5,5,5,5,5,5,10,10,10,10,5,5,5,7,1,
1,7,10,10,10,10,10,10,10,10,10,10,10,10,10,10,10,10,10,10,10,10,10,10,3,3,10,5,5,5,5,5,5,5,5,5,5,5,5,10,10,10,10,10,10,5,5,5,7,1,
1,7,5,5,5,5,5,5,5,5,5,5,5,5,5,10,10,10,10,5,5,5,5,5,3,3,10,5,13,5,5,5,5,5,5,5,5,5,5,5,5,5,5,5,5,5,5,5,7,1,
1,7,5,10,10,10,10,10,10,5,10,5,10,10,5,5,5,5,5,5,11,5,5,10,3,3,10,5,5,5,5,5,5,5,5,5,5,5,5,5,5,5,5,5,5,5,5,5,7,1,
1,7,5,5,5,5,5,11,5,5,10,5,5,10,10,10,10,5,10,5,11,5,5,10,3,3,10,5,8,8,8,8,8,5,5,8,8,8,8,8,5,5,10,10,10,10,10,10,7,1,
1,7,8,8,8,8,5,11,5,10,10,10,5,10,5,5,5,5,10,5,11,11,5,10,3,3,10,5,5,5,5,5,5,5,5,5,5,5,5,5,5,5,5,5,5,5,5,5,7,1,
1,7,5,5,5,5,5,11,5,5,5,5,5,10,5,11,10,10,10,11,11,11,5,10,3,3,10,5,8,8,8,8,8,5,5,8,8,8,8,8,5,5,10,10,10,10,10,10,7,1,
1,7,10,10,10,10,10,10,10,10,10,10,5,10,5,11,5,11,5,11,5,11,5,10,3,3,10,5,5,5,5,5,5,5,5,5,5,5,5,5,5,5,5,5,5,5,5,5,7,1,
1,7,5,5,5,5,5,5,5,5,5,5,5,10,5,5,5,5,5,5,5,5,5,10,3,3,10,5,8,8,8,8,8,5,5,8,8,8,8,8,5,5,10,10,10,10,10,10,7,1,
1,7,5,10,10,10,10,10,10,10,10,10,10,10,10,10,10,10,10,10,10,10,10,10,3,3,10,5,5,5,5,5,5,5,5,5,5,5,5,5,5,5,5,5,5,5,5,5,7,1,
1,7,5,5,5,5,5,5,5,5,5,5,5,5,5,5,5,5,5,5,5,5,5,5,3,3,10,5,5,5,5,5,5,5,5,5,5,5,5,5,5,5,5,5,5,5,5,5,7,1,
1,2,2,2,2,2,2,2,2,2,2,2,2,2,2,2,2,2,2,2,2,2,2,2,2,2,2,2,2,2,2,2,2,2,2,2,2,2,2,2,2,2,2,2,2,2,2,2,2,1,
1,1,1,1,1,1,1,1,1,1,1,1,1,1,1,1,1,1,1,1,1,1,1,1,1,1,1,1,1,1,1,1,1,1,1,1,1,1,1,1,1,1,1,1,1,1,1,1,1,1